##########
#........#
#........#
#.######.#
#.######.#
#.######.#
#...####.#
#...####.#
#...####.#
#........#
##########
\robot 1 1
\robot 2 2
\robot 3 4